5 6
%E   %
%   %%
%% %%%
%S  %%
%%%%%%
